XXXXXXXXXXXXXXXXXX
XXXXXXXX..XXXXXXXX
XXXXXXXX..XXXXXXXX
XXXX..........XXXX
XXX............XXX
XXX...BB..BB...XXX
XXX..BBB..BBB..XXX
XXX1BX......XB.XXX
XXX.BB......BB.XXX
X................X
X................X
XXX.BB......BB.XXX
XXX1BX......XB1XXX
XXX..BBB..BBB..XXX
XXX...BB..BB...XXX
XXX............XXX
XXXX..S.......XXXX
XXXXXXXX..XXXXXXXX
XXXXXXXX..XXXXXXXX
XXXXXXXXXXXXXXXXXX